17 17 17 17 17 17 17 17 17 17 17 17 17 17 17 17 17 17 17 17 17 17 17 17 17 17 17 17 17 17 17 17 17 17 17 17 17 17 17 17 17 17 17 17 17 17 17 17 17 17
17 17 17 17 17 17 17 17 17 17 17 17 17 17 32 17 17 17 17 17 17 17 17 17 17 17 17 17 17 17 17 17 17 17 17 17 17 17 17 17 17 17 17 17 17 17 17 17 17 17
17 17 17 17 17 17 17 32 17 17 17 17 17 17 17 17 17 17 17 17 17 17 17 17 17 32 17 17 17 17 17 17 17 32 17 17 17 17 17 17 17 17 17 17 17 17 17 17 17 17
17 17 17 17 32 17 17 17 17 17 17 32 17 17 17 17 17 17 32 17 17 17 17 17 17 17 17 32 17 17 17 17 17 17 17 17 17 17 17 17 17 32 17 17 17 17 17 17 17 17
17 17 17 17 17 17 17 17 17 32 17 17 17 17 17 32 17 17 17 17 17 17 17 32 17 17 17 17 17 17 17 32 17 17 32 17 17 17 32 17 17 17 17 17 17 17 17 17 17 17
17 17 17 17 17 17 17 17 17 17 17 17 17 17 17 17 17 17 17 17 17 32 17 17 17 17 17 17 17 32 17 17 17 17 17 17 32 17 17 17 17 17 17 32 17 17 17 17 17 17
17 17 17 17 17 32 29 21 21 21 21 21 21 21 28 17 17 17 29 21 21 21 21 21 21 21 21 28 17 17 17 29 21 21 21 21 21 21 21 21 21 21 28 17 17 17 17 17 17 17
17 17 17 17 17 17 19 35 37 37 37 37 37 35 22 21 21 21 20 35 43 43 34 43 43 43 43 22 21 21 21 20 35 43 13 11 11 11 11 11 11 14 23 17 17 32 17 17 17 17
17 17 32 17 17 17 19 35 37 36 36 36 37 35 35 35 35 35 35 35 43 24 25 25 25 18 43 35 35 35 35 35 35 35 42 33 33 33 33 33 33 41 23 17 17 17 17 17 17 17
17 17 17 17 17 17 19 35 37 36 36 36 37 35 35 35 35 35 35 35 43 23 17 17 17 19 43 35 35 35 35 35 35 35 42 33 33 33 33 33 33 41 23 17 17 17 17 17 17 17
17 17 17 32 17 17 19 35 37 36 36 36 37 35 35 35 35 35 35 35 43 23 17 17 17 19 34 35 35 35 35 35 35 35 42 33 33 33 33 33 33 41 23 17 32 17 17 17 17 17
17 17 17 17 32 17 19 35 37 36 36 36 37 35 35 35 35 35 35 35 43 22 21 21 21 20 43 35 35 35 35 35 35 35 42 33 33 33 33 33 33 41 23 17 17 17 17 17 17 17
17 17 17 17 17 17 19 35 37 37 36 37 37 35 35 35 35 35 35 35 34 43 13 11 14 43 43 35 35 35 35 35 35 35 15 39 39 40 33 38 39 16 23 32 17 17 17 17 17 17
17 17 17 17 17 17 19 35 35 35 43 35 35 35 35 35 35 35 35 35 35 35 42 33 41 35 35 35 35 35 35 35 35 35 35 35 35 42 33 41 43 24 27 17 17 17 17 17 17 17
17 17 17 17 32 17 19 35 35 35 43 35 35 35 35 35 35 35 35 35 35 35 42 33 41 35 35 35 35 35 35 35 35 35 35 35 35 42 33 41 24 27 17 17 17 32 17 17 17 17
17 17 17 17 17 17 31 25 18 35 43 35 35 35 35 35 35 35 35 35 35 35 42 33 41 43 34 44 35 35 35 35 35 35 35 35 35 42 33 41 23 17 17 17 17 17 17 17 17 17
17 17 17 17 17 17 17 17 19 35 43 35 35 35 35 35 35 35 35 35 35 35 42 33 41 35 35 35 35 35 35 35 35 35 35 35 35 42 33 41 23 17 17 17 17 17 32 17 17 17
17 17 32 17 17 17 17 29 20 35 43 35 35 35 35 35 35 35 35 35 35 35 42 33 41 35 35 35 35 35 35 35 35 35 35 13 11 12 33 41 23 17 17 32 17 17 17 17 17 17
17 17 17 17 17 17 17 19 43 43 43 35 35 35 35 35 35 35 35 35 35 35 42 33 41 35 35 35 35 35 35 35 35 35 35 42 33 33 33 41 23 17 17 17 17 17 17 17 17 17
17 17 17 32 17 17 17 19 43 35 35 35 35 35 35 35 35 35 35 35 35 43 42 33 41 43 35 35 35 35 35 35 35 35 35 42 33 38 39 16 23 17 32 17 17 17 17 17 17 17
17 17 17 17 17 17 17 19 43 35 35 35 35 35 13 11 11 11 11 11 11 11 12 33 10 11 11 11 11 11 11 11 11 11 11 12 33 41 43 43 23 17 17 17 17 17 17 17 17 17
17 17 17 17 17 32 17 19 43 35 35 35 34 43 42 33 33 33 33 33 33 33 33 33 33 33 33 33 33 33 33 33 33 33 33 33 33 41 43 43 23 17 17 17 17 17 17 17 17 17
17 17 17 17 17 17 32 19 43 43 35 35 43 35 15 39 39 39 39 39 39 39 40 33 38 39 39 39 39 39 39 39 39 39 39 40 33 41 43 24 27 32 17 17 17 17 17 17 17 17
17 17 17 17 17 17 17 31 18 43 35 35 43 35 35 35 35 35 35 35 35 43 42 33 41 43 35 35 35 35 35 35 35 35 35 42 33 41 43 23 17 17 17 17 32 17 17 17 17 17
17 17 17 17 17 17 17 17 19 43 35 35 43 35 35 35 35 35 35 35 35 35 42 33 41 35 35 35 35 35 35 35 35 35 35 42 33 41 34 23 17 17 17 17 17 17 17 17 17 17
17 17 17 17 17 32 17 29 20 43 35 35 43 43 43 35 35 35 35 35 35 35 42 33 41 35 35 35 35 35 35 35 35 35 35 42 33 41 43 23 17 17 17 32 17 17 17 17 17 17
17 17 17 17 17 17 17 19 43 43 35 35 35 35 43 35 35 35 35 35 35 35 42 33 41 35 35 35 35 35 35 35 35 35 35 42 33 41 43 23 17 17 17 17 17 17 17 17 17 17
17 17 17 32 17 17 17 19 43 35 35 35 35 35 43 35 35 35 35 35 35 35 42 33 41 35 35 43 35 35 35 35 35 35 35 42 33 41 43 23 17 32 17 17 17 17 17 17 17 17
17 17 17 17 17 17 17 19 43 35 35 35 35 35 43 35 35 35 35 35 35 35 42 33 41 35 35 35 35 35 43 35 35 35 35 42 33 41 43 23 17 17 17 17 17 17 17 17 17 17
17 17 17 17 17 17 32 19 43 43 43 43 43 43 43 35 35 35 35 35 35 35 42 33 41 35 35 35 35 35 43 35 35 35 35 15 39 16 43 23 17 17 17 17 32 17 17 17 17 17
17 17 17 17 17 17 17 19 43 43 34 43 43 43 43 35 35 35 35 35 35 35 42 33 41 35 35 35 35 35 35 35 35 35 35 35 43 35 43 23 17 17 32 17 17 17 17 17 17 17
17 17 17 17 17 17 17 31 18 43 43 43 43 43 43 35 35 35 35 35 35 35 42 33 41 35 35 35 35 35 35 35 35 35 35 43 43 43 24 27 17 17 17 17 17 17 17 17 17 17
17 17 17 17 17 32 17 17 19 43 43 43 43 34 43 35 35 35 35 35 35 35 42 33 41 35 35 35 35 35 35 35 35 35 35 43 43 43 23 17 17 17 17 17 17 17 32 17 17 17
17 17 17 17 17 17 17 17 19 34 43 43 43 43 43 35 35 35 35 35 35 35 42 33 41 35 35 35 35 35 35 35 35 35 35 43 43 34 23 17 17 32 17 17 17 17 17 17 17 17
17 17 17 17 17 17 17 17 19 43 43 43 43 43 43 35 35 35 35 35 35 35 42 33 41 35 35 35 35 35 35 35 35 35 35 43 43 43 23 17 17 17 17 17 17 17 17 17 17 17
17 17 17 17 32 17 17 29 20 35 35 35 35 35 35 35 35 35 35 35 35 35 15 39 16 35 35 35 35 35 35 35 35 35 35 34 43 43 22 28 17 17 17 17 17 17 17 17 17 17
17 17 17 17 17 17 17 19 35 35 35 35 35 35 35 35 35 35 35 43 43 43 43 43 43 43 43 35 35 35 35 35 35 35 43 43 43 43 43 22 28 17 17 17 32 17 17 17 17 17
17 17 17 17 17 17 32 19 35 35 35 35 35 35 35 35 35 35 43 43 43 43 43 43 43 43 43 43 35 35 43 35 35 43 43 43 43 43 43 43 23 17 17 17 17 17 17 17 17 17
17 17 17 17 17 17 17 19 43 35 35 35 35 35 35 35 35 35 43 34 43 43 43 43 43 34 43 43 35 35 35 35 43 43 43 43 43 34 43 43 23 17 32 17 17 17 17 17 17 17
17 17 17 17 17 17 17 19 43 35 35 35 35 35 35 35 35 35 43 43 34 43 43 43 43 43 43 43 43 35 35 35 43 43 43 43 43 35 43 43 23 17 17 17 17 17 17 17 17 17
17 17 32 17 17 17 17 19 43 35 35 35 35 35 35 35 35 35 43 43 43 43 43 43 43 43 43 43 43 43 43 43 43 43 35 43 43 43 43 43 23 17 17 17 17 32 17 17 17 17
17 17 17 17 17 17 17 19 43 35 35 35 35 43 35 35 24 25 18 43 43 43 43 43 34 43 43 43 24 25 18 43 43 43 43 43 43 43 34 43 23 17 17 17 17 17 17 32 17 17
17 17 17 17 17 17 17 19 35 35 35 35 35 35 35 24 27 17 31 18 43 43 43 43 43 43 43 24 27 17 19 43 43 35 43 43 35 43 43 43 23 17 17 17 17 17 17 17 17 17
17 17 17 17 32 17 17 24 25 25 25 25 25 25 25 27 17 17 17 31 25 25 25 25 25 25 25 27 32 17 31 18 43 34 43 43 43 43 43 24 27 17 32 17 17 17 17 17 17 17
17 17 17 17 17 17 17 17 17 17 17 17 17 17 17 17 17 17 32 17 17 17 17 17 17 17 17 17 17 17 17 31 25 25 25 25 25 25 25 27 17 17 17 17 17 17 32 17 17 17
17 17 17 17 17 17 17 17 17 17 17 32 17 17 17 17 32 17 17 17 17 17 17 17 17 17 17 17 17 17 17 17 17 17 17 17 32 17 17 17 17 17 17 32 17 17 17 17 17 17
17 17 17 17 17 17 32 17 17 17 17 17 17 17 17 17 17 17 17 17 17 17 17 17 32 17 17 17 17 32 17 17 17 17 17 17 17 17 17 17 17 17 17 17 17 17 17 17 17 17
17 17 17 17 17 17 17 17 17 17 17 17 17 17 32 17 17 17 17 17 32 17 17 17 17 17 17 17 17 17 17 17 32 17 17 17 17 17 17 32 17 17 17 17 17 17 17 17 17 17
17 17 17 17 17 17 17 17 17 17 17 17 17 17 17 17 17 17 17 17 17 17 17 17 17 17 17 32 17 17 17 17 17 17 17 17 17 17 17 17 17 17 17 17 17 32 17 17 17 17
17 17 17 17 17 17 17 17 17 17 17 17 17 17 17 17 17 17 17 17 17 17 17 17 17 17 17 17 17 17 17 17 17 17 17 17 17 17 17 17 17 17 17 17 17 17 17 17 17 17