1 1 1 1 1 1 7 7 7 7 7 7 7 7 7 7 7 7 7 7 7 7 7 7 7 7 1 1 1 1 1 1 1 1 1 1 1 1 1 1 1 1 1 1 1 1 1 1 1 1
1 1 1 7 1 7 7 7 6 6 6 6 6 6 6 6 6 6 6 6 6 6 6 6 6 7 1 1 1 7 1 1 1 1 1 1 1 1 1 1 1 1 1 1 1 1 1 1 1 1
1 1 1 1 7 7 6 6 6 7 7 7 7 7 7 7 7 7 7 7 7 7 7 7 6 7 1 1 7 1 1 1 1 1 1 1 1 1 1 1 7 1 1 1 1 1 1 1 1 1
1 7 1 7 6 6 6 7 7 7 1 1 7 3 3 3 3 7 1 7 1 1 1 7 6 7 1 1 1 1 1 7 1 1 1 1 1 1 1 1 1 1 1 1 1 1 1 1 7 1
1 1 1 7 6 7 7 1 1 1 1 7 3 3 5 5 3 3 7 1 7 1 1 7 6 7 1 1 7 1 1 1 7 1 1 1 1 1 1 1 1 1 1 1 1 1 1 1 1 1
1 1 1 7 6 7 1 1 1 1 7 3 3 5 5 5 5 5 3 7 1 1 1 7 6 7 1 1 1 1 1 1 1 1 1 1 1 1 1 1 1 1 1 1 7 1 1 1 1 1
1 1 1 7 6 7 1 1 1 7 3 3 5 5 5 5 5 5 3 1 7 7 1 7 6 7 1 1 1 1 1 1 1 1 1 1 1 7 1 1 1 1 1 1 1 1 1 1 7 1
1 1 7 7 6 7 1 1 1 7 3 3 5 5 5 5 5 3 6 1 1 7 1 7 6 7 1 1 7 1 1 1 1 1 1 1 1 1 1 1 1 1 1 1 1 1 1 1 1 1
7 1 1 7 6 7 1 7 1 1 7 3 3 5 5 5 5 3 6 1 1 7 1 7 6 7 1 1 1 1 1 1 7 1 1 1 1 1 1 1 1 1 1 1 1 1 1 1 1 1
1 1 1 7 6 7 1 1 1 1 7 3 3 3 3 5 3 3 6 1 1 7 1 7 6 7 1 1 1 1 1 1 1 1 1 1 1 1 7 1 1 1 1 1 1 2 2 2 2 2
1 1 1 7 6 7 1 1 1 1 1 7 7 3 3 3 3 3 6 1 1 7 1 7 6 7 1 1 1 1 1 1 1 1 1 1 1 1 1 1 1 7 1 1 1 2 0 0 0 2
1 1 7 7 6 7 1 1 7 1 1 1 1 7 7 3 3 1 6 1 1 7 1 7 6 7 1 1 1 7 1 1 1 1 1 1 1 1 1 1 1 1 1 7 1 2 0 0 0 2
7 1 1 7 6 7 1 1 1 1 1 1 1 1 7 1 1 1 6 1 1 7 1 7 6 7 1 1 1 1 1 1 1 1 1 1 7 1 1 1 7 1 1 1 1 2 0 0 0 2
1 1 1 7 6 7 1 1 1 1 7 1 1 1 7 1 1 1 6 1 1 7 1 7 6 7 1 1 1 1 7 1 1 1 1 1 1 1 1 1 1 7 1 1 1 2 2 0 2 2
1 1 1 7 6 7 1 1 1 1 1 1 1 1 1 7 1 1 6 1 1 7 1 7 6 7 1 1 1 1 1 1 1 1 1 1 1 1 1 1 1 1 1 7 1 7 1 1 1 7
1 1 7 7 6 7 1 1 1 1 1 1 1 1 1 7 7 6 6 1 7 1 1 7 6 7 1 1 7 1 1 1 1 1 7 1 1 7 1 1 1 1 7 1 7 7 7 1 1 7
1 1 1 7 6 7 1 1 1 1 7 7 1 7 1 7 6 6 7 7 1 1 7 7 6 7 1 1 1 1 1 1 1 1 1 1 1 1 1 1 1 1 1 1 7 1 1 1 1 7
1 1 1 7 6 7 1 1 1 7 1 1 1 1 1 7 6 7 7 1 1 1 1 7 6 7 1 1 1 7 1 1 1 1 1 1 1 1 1 1 1 7 1 1 7 1 1 1 1 7
1 7 7 7 6 1 7 7 7 1 1 1 1 1 7 7 6 7 1 1 7 1 1 7 6 7 1 1 1 1 1 1 1 1 1 1 7 1 1 1 1 1 1 1 7 1 1 1 1 7
7 1 1 1 6 1 1 1 7 7 1 1 7 1 7 6 6 7 1 1 1 7 1 7 6 7 1 1 1 1 1 1 1 1 1 1 1 1 1 1 1 1 1 1 1 7 7 1 1 7
7 1 1 1 6 1 7 1 1 7 7 1 1 1 7 6 7 7 1 1 7 1 1 7 6 7 1 1 1 1 1 1 1 1 1 1 1 1 1 1 1 1 1 1 1 1 1 7 1 7
7 1 1 1 6 6 6 6 6 6 7 7 1 1 7 6 7 1 1 7 1 1 1 7 6 7 1 1 1 1 1 1 1 1 1 1 1 1 1 1 1 1 1 1 1 1 1 7 1 7
7 1 1 1 1 1 1 1 7 6 7 1 1 1 7 6 7 1 1 1 1 1 7 6 6 6 7 1 1 1 1 1 1 1 1 1 1 1 1 1 1 1 1 1 1 1 1 7 1 7
7 1 1 7 1 1 1 1 6 6 7 1 1 1 7 6 7 7 7 7 7 7 6 6 6 6 6 7 7 7 7 7 7 7 7 7 7 7 7 7 7 7 7 7 7 7 7 7 1 7
1 7 1 1 1 1 1 1 6 7 7 1 7 1 7 6 6 6 6 6 6 6 6 6 6 6 6 6 6 6 6 6 6 6 6 6 6 6 6 6 6 6 6 6 6 6 6 7 1 7
1 1 7 1 1 1 1 1 6 7 1 1 1 1 7 7 7 7 7 7 7 7 6 6 6 6 6 7 7 7 7 7 7 7 7 7 7 7 7 7 7 7 7 7 7 7 6 7 1 7
1 1 1 7 7 1 1 7 6 7 1 1 1 1 1 1 1 7 1 1 1 1 7 6 6 6 7 1 1 1 1 1 1 1 1 1 1 1 1 1 1 1 1 1 1 7 6 7 1 7
1 1 1 7 6 6 6 6 6 7 1 1 7 1 1 1 1 1 1 1 1 1 1 7 6 7 1 1 1 7 1 1 1 1 1 1 1 1 1 1 1 1 1 1 7 7 6 7 1 7
1 1 1 1 7 1 1 1 7 1 1 1 1 1 1 1 1 7 1 1 1 1 1 7 6 7 1 1 1 1 1 1 1 1 1 1 1 1 1 1 1 1 1 7 7 1 6 7 1 7
1 1 1 7 7 7 7 7 1 1 1 1 1 1 7 1 1 1 1 1 1 1 1 7 6 7 1 1 7 1 1 7 1 1 1 1 1 1 1 1 7 7 7 7 6 6 6 7 1 7
1 1 1 1 1 1 1 1 1 1 1 1 1 1 1 1 7 1 1 7 1 1 1 7 6 7 1 1 1 1 1 1 1 1 1 1 1 1 1 1 7 7 6 6 6 1 1 7 1 7
1 1 1 1 1 1 1 1 1 1 1 1 1 1 7 1 1 1 1 1 1 7 1 7 6 7 1 7 1 1 1 1 1 1 1 1 1 1 1 7 7 6 6 1 1 1 3 7 1 7
1 1 1 1 1 1 1 1 1 1 1 1 1 1 1 1 1 1 1 1 1 1 1 7 6 7 1 1 1 1 1 7 1 1 1 1 1 1 7 7 6 6 1 1 3 3 3 7 1 7
1 1 1 1 1 1 1 1 1 1 1 1 1 1 1 1 1 1 1 7 1 1 1 7 6 7 1 1 1 1 1 1 1 1 1 1 1 7 7 3 3 3 3 3 3 3 3 7 1 7
1 1 1 1 1 1 1 1 1 1 1 1 1 1 1 1 7 1 1 1 1 1 1 7 6 7 1 1 1 7 1 1 1 1 1 1 1 7 5 5 3 3 3 3 3 3 3 7 1 7
1 1 1 1 1 1 1 1 1 1 1 1 1 1 1 1 1 1 1 1 1 1 1 7 6 7 1 1 1 1 1 7 1 1 1 1 1 7 5 5 5 3 3 3 3 3 3 7 1 7
1 1 1 1 1 1 1 1 1 1 1 1 1 1 7 1 1 1 1 1 7 1 1 7 6 7 1 1 1 1 1 1 1 1 1 7 7 5 5 5 5 3 3 3 5 5 5 7 1 7
1 1 1 1 1 1 1 1 1 1 1 1 1 1 1 1 1 1 1 1 1 1 7 7 6 7 1 1 7 1 1 1 1 1 7 7 5 5 5 5 5 3 3 5 5 5 5 7 1 7
1 1 1 1 1 1 1 1 1 1 1 1 1 7 1 1 1 1 7 1 1 7 7 6 6 7 1 1 1 1 1 1 1 1 7 7 5 5 5 5 5 3 5 5 5 5 5 7 1 7
1 1 1 1 1 1 1 1 1 1 1 1 1 1 1 7 1 1 1 1 7 7 6 6 7 7 1 1 1 7 1 1 1 7 7 5 5 5 5 5 5 3 5 5 5 5 5 7 1 7
1 1 1 1 1 1 1 1 1 1 1 1 1 1 1 7 7 7 7 7 7 6 6 7 7 1 1 7 1 1 1 1 7 7 5 5 5 5 5 5 5 3 3 5 5 5 5 7 1 7
1 1 1 1 1 1 1 1 1 1 1 1 1 7 1 7 6 6 6 6 6 6 7 7 1 1 1 1 1 1 1 1 7 7 5 5 5 5 5 5 5 3 3 5 5 5 5 7 1 7
1 1 1 1 1 1 1 1 1 1 1 1 3 3 3 7 6 7 7 7 7 7 7 1 1 1 1 7 1 1 1 1 1 7 7 5 5 5 5 5 5 3 3 5 5 5 5 7 1 7
1 1 1 1 1 1 1 1 1 1 1 3 3 3 5 5 6 6 3 7 7 7 1 1 1 1 1 1 1 1 7 1 1 7 7 5 5 5 5 5 5 3 3 3 5 5 5 7 1 7
1 1 1 1 1 1 1 1 1 3 3 3 5 5 5 5 5 6 6 6 6 7 7 7 7 1 1 1 1 1 1 1 1 7 7 5 5 5 5 5 5 3 3 3 5 5 5 7 1 7
1 1 1 1 1 1 1 1 3 3 3 5 5 5 5 5 5 5 3 3 6 6 6 6 6 7 1 1 1 1 1 1 7 7 5 5 5 5 5 5 5 3 3 3 5 5 5 7 1 7
1 1 1 1 1 1 1 3 3 3 5 5 5 5 5 5 5 5 3 3 3 1 1 1 1 7 7 1 1 7 1 1 7 7 5 5 5 5 5 5 5 5 3 3 5 5 5 7 1 7
1 1 1 1 1 1 1 3 3 3 5 5 5 5 5 5 5 3 3 3 1 1 7 1 7 1 7 1 1 1 1 1 7 7 5 5 5 5 5 5 5 5 3 3 3 5 5 7 1 7
1 1 1 1 1 1 1 1 3 3 3 5 5 5 5 5 5 5 3 3 1 1 1 1 1 7 1 1 1 1 7 1 7 7 5 5 5 5 5 5 5 5 3 3 3 3 3 3 1 7
1 1 1 1 1 1 1 1 1 3 3 3 5 5 5 5 5 5 5 7 7 7 7 7 7 1 1 1 1 1 1 1 7 7 7 7 7 7 7 7 7 7 7 7 7 7 7 7 7 7


